202
12
0 0 0 0 0 0 0 0 0 0 0 0 0 0 0 0 0 0 0 10 12 14 0  0 0  0 0 0  0  0  0  0  0 0 0 0 10 12 12 14 0 0 0 0 0 0 0 0  0  0 0 0 0 0 0 0 0 0  0  0  0 0 0 0 0 0 0 10 12 14 0 0 0 0 0 0  0  0  0  0  0  0  0  0  10 12 12 14 0 0 0 0  0  0  0  0 0 0 0 0 0  0  0 0 0  0  0  0 0 0 0 0 0 0 0 10 12 14 0  0 0 0  0  0  0  0  0  0  0  0  0  0  10 12 12 14 0  0  0 0 0  0  0  0  0 0 0 0 0  0  0  0  0  0  0  0  0  0  0  0 0 0 0 10 12 14 0 0 0  0  0 0  0  0  0  0  0 0 0 10 12 12 14 0  0  0  0  0  0  0  0 0 0 0 0 0 0  25 0 0  0  0
0 0 0 0 0 0 0 0 0 0 0 0 0 0 0 0 0 0 0 11 13 15 0  0 0  0 0 10 12 12 12 14 0 0 0 0 11 13 13 15 0 0 0 0 0 0 0 0  0  0 0 0 0 0 0 0 0 10 12 14 0 0 0 0 0 0 0 11 13 15 0 0 0 0 0 10 12 12 12 14 0  0  0  0  11 13 13 15 0 0 0 0  0  0  0  0 0 0 0 0 0  0  0 0 10 12 14 0 0 0 0 0 0 0 0 11 13 15 0  0 0 0  0  10 12 12 12 14 0  0  0  0  11 13 13 15 0  0  0 0 0  0  0  0  0 0 0 0 0  0  0  0  10 12 14 0  0  0  0  0 0 0 0 11 13 15 0 0 0  0  0 10 12 12 12 14 0 0 0 11 13 13 15 0  0  0  0  0  0  0  0 0 0 0 0 0 24 23 0 10 12 14
0 0 0 0 0 0 0 0 0 0 0 0 0 0 0 0 0 0 0 0  0  0  0  0 0  0 0 11 13 13 13 15 0 0 0 0 0  0  0  0  0 0 0 0 0 0 0 0  0  0 0 0 0 0 0 0 0 11 13 15 0 0 0 0 0 0 0 0  0  0  0 0 0 0 0 11 13 13 13 15 0  0  0  0  0  0  0  0  0 0 0 0  0  0  0  0 0 0 0 0 0  0  0 0 11 13 15 0 0 0 0 0 0 0 0 0  0  0  0  0 0 0  0  11 13 13 13 15 0  0  0  0  0  0  0  0  0  0  0 0 0  0  0  0  0 0 0 0 0  0  0  0  11 13 15 0  0  0  0  0 0 0 0 0  0  0  0 0 0  0  0 11 13 13 13 15 0 0 0 0  0  0  0  0  0  0  0  0  0  0  0 0 0 0 0 0 0  22 0 11 13 15
0 0 0 0 0 0 0 0 0 0 0 0 0 0 0 0 0 0 0 0  0  0  9  0 0  0 0 0  0  0  0  0  0 0 0 0 0  0  0  0  0 0 0 0 0 0 0 0  0  0 0 0 0 0 0 0 0 0  0  0  0 0 0 0 0 0 0 0  0  0  0 0 0 0 0 0  0  0  0  0  16 16 16 16 16 16 16 16 0 0 0 16 16 16 9  0 0 0 0 0 0  0  0 0 0  0  0  0 0 9 0 0 0 0 0 0  0  0  0  0 0 16 16 16 0  0  0  0  16 9  9  16 0  0  0  0  0  0  0 0 0  0  0  0  0 0 0 0 0  0  0  0  0  0  0  0  0  0  0  0 0 0 0 0  0  0  0 0 0  0  0 0  0  0  0  0  0 0 0 0  0  0  0  0  0  0  0  0  0  0  0 0 0 0 0 0 0  22 0 0  0  0
0 0 0 0 0 0 0 0 0 0 0 0 0 0 0 0 0 0 0 0  0  0  0  0 0  0 0 0  0  0  0  0  0 0 0 0 0  0  0  0  0 0 0 0 0 0 0 0  0  0 0 0 0 0 0 0 0 0  0  0  0 0 0 0 0 0 0 0  0  0  0 0 0 0 0 0  0  0  0  0  0  0  0  0  0  0  0  0  0 0 0 0  0  0  0  0 0 0 0 0 0  0  0 0 0  0  0  0 0 0 0 0 0 0 0 0  0  0  0  0 0 0  0  0  0  0  0  0  0  0  0  0  0  0  0  0  0  0  0 0 0  0  0  0  0 0 0 0 0  0  0  0  0  0  0  0  0  0  0  0 0 0 0 0  0  0  0 0 0  0  0 0  0  0  0  0  0 0 0 0  0  0  0  0  0  0  0  0  21 21 0 0 0 0 0 0 0  22 0 0  0  0
0 0 0 0 0 0 0 0 0 0 0 0 0 0 0 0 0 0 0 0  0  0  0  0 0  0 0 0  0  0  0  0  0 0 0 0 0  0  0  0  0 0 0 0 0 0 0 0  0  0 0 0 0 0 0 0 0 0  0  0  0 0 0 0 0 0 0 0  0  0  0 0 0 0 0 0  0  0  0  0  0  0  0  0  0  0  0  0  0 0 0 0  0  0  0  0 0 0 0 0 0  0  0 0 0  0  0  0 0 0 0 0 0 0 0 0  0  0  0  0 0 0  0  0  0  0  0  0  0  0  0  0  0  0  0  0  0  0  0 0 0  0  0  0  0 0 0 0 0  0  0  0  0  0  0  0  0  0  0  0 0 0 0 0  0  0  0 0 0  0  0 0  0  0  0  0  0 0 0 0  0  0  0  0  0  0  0  21 21 21 0 0 0 0 0 0 0  22 0 0  0  0
0 0 0 0 0 0 0 0 0 0 0 0 0 0 0 0 0 0 0 0  0  0  0  0 0  0 0 0  0  0  0  0  0 0 0 0 0  0  0  0  0 0 0 0 0 0 0 0  0  0 0 0 0 0 0 0 0 0  0  0  0 0 0 0 0 0 0 0  0  0  0 0 0 0 0 0  0  0  0  0  0  0  0  0  0  0  0  0  0 0 0 0  0  0  0  0 0 0 0 0 0  0  0 0 0  0  0  0 0 0 0 0 0 0 0 0  0  0  0  0 0 0  0  0  0  0  0  0  0  0  0  0  0  0  0  0  0  0  0 0 0  0  0  0  0 0 0 0 0  0  0  0  0  0  0  0  0  0  0  0 0 0 0 0  0  0  0 0 0  0  0 0  0  0  0  0  0 0 0 0  0  0  0  0  0  0  21 21 21 21 0 0 0 0 0 0 0  22 0 0  0  0
0 0 0 0 0 0 0 0 0 0 0 0 0 0 0 0 9 0 0 0  16 9  16 9 16 0 0 0  0  0  0  0  0 0 0 0 0  0  0  0  0 0 0 0 0 0 0 17 18 0 0 0 0 0 0 0 0 0  17 18 0 0 0 0 0 0 0 0  0  0  0 0 0 0 0 0  0  16 9  16 0  0  0  0  0  0  0  0  0 0 0 0  0  0  16 0 0 0 0 0 16 16 0 0 0  0  9  0 0 9 0 0 9 0 0 0  0  0  16 0 0 0  0  0  0  0  0  0  0  16 16 0  0  0  0  0  0  21 0 0 21 0  0  0  0 0 0 0 0  0  0  21 21 0  0  21 0  0  0  0 0 0 0 0  0  0  0 0 0  0  0 0  0  0  0  0  0 0 0 0  0  0  0  0  0  21 21 21 21 21 0 0 0 0 0 0 0  22 0 0  0  0
0 0 0 0 0 0 0 0 0 0 0 0 0 0 0 0 0 0 0 0  0  0  0  0 0  0 0 0  0  0  0  0  0 0 0 0 0  0  17 18 0 0 0 0 0 0 0 19 20 0 0 0 0 0 0 0 0 0  19 20 0 0 0 0 0 0 0 0  0  0  0 0 0 0 0 0  0  0  0  0  0  0  0  0  0  0  0  0  0 0 0 0  0  0  0  0 0 0 0 0 0  0  0 0 0  0  0  0 0 0 0 0 0 0 0 0  0  0  0  0 0 0  0  0  0  0  0  0  0  0  0  0  0  0  0  0  21 21 0 0 21 21 0  0  0 0 0 0 0  0  21 21 21 0  0  21 21 0  0  0 0 0 0 0  0  0  0 0 0  0  0 0  0  0  0  0  0 0 0 0  0  0  0  0  21 21 21 21 21 21 0 0 0 0 0 0 0  22 0 0  0  0
0 2 4 5 0 0 0 0 0 0 0 0 0 0 0 0 0 0 0 0  0  0  0  0 0  0 0 0  17 18 0  0  0 0 0 0 0  0  19 20 0 0 0 0 0 0 0 19 20 0 2 3 5 0 0 0 0 0  19 20 0 0 0 0 0 0 0 0  0  0  0 0 0 0 0 0  0  0  0  0  0  0  0  0  0  0  0  0  0 0 0 0  0  0  0  0 0 2 3 5 0  0  0 0 0  0  0  0 0 0 0 0 0 0 0 0  0  0  0  0 0 0  0  0  0  0  0  0  0  0  0  0  0  0  0  21 21 21 0 0 21 21 21 0  0 2 3 5 0  21 21 21 21 0  0  21 21 21 0  0 0 0 0 17 18 0  0 0 16 16 9 16 0  0  0  0  0 0 0 17 18 0  21 21 21 21 21 21 21 21 0 0 0 2 4 5 0  22 0 0  0  0
2 3 4 3 5 0 0 0 0 0 0 6 7 7 7 8 2 3 5 0  0  0  0  6 7  8 0 0  19 20 0  0  0 0 0 0 0  0  19 20 0 6 7 7 8 0 0 19 20 2 3 4 3 5 0 0 0 0  19 20 6 7 7 8 2 3 5 0  0  0  0 6 7 8 0 0  0  0  0  0  0  0  0  0  0  0  0  0  0 6 7 7  8  0  0  0 2 3 4 3 5  0  0 0 0  0  0  6 7 7 7 8 2 3 5 0  0  0  0  6 7 8  0  0  0  0  0  0  0  0  0  0  0  0  21 21 21 21 7 7 21 21 21 21 2 3 4 3 21 21 21 21 21 0  0  21 21 21 21 8 2 3 5 19 20 0  0 6 7  8  0 0  0  0  0  0  0 0 0 19 20 21 21 21 21 21 21 21 21 21 0 0 2 3 4 3 5  21 0 0  0  0
1 1 1 1 1 1 1 1 1 1 1 1 1 1 1 1 1 1 1 1  1  1  1  1 1  1 1 1  1  1  1  1  1 1 1 1 1  1  1  1  1 1 1 1 1 1 1 1  1  1 1 1 1 1 1 1 1 1  1  1  1 1 1 1 1 1 1 1  1  0  0 1 1 1 1 1  1  1  1  1  1  1  1  1  1  1  0  0  0 1 1 1  1  1  1  1 1 1 1 1 1  1  1 1 1  1  1  1 1 1 1 1 1 1 1 1  1  1  1  1 1 1  1  1  1  1  1  1  1  1  1  1  1  1  1  1  1  1  1 1 1  1  1  1  1 1 1 1 1  1  1  1  1  0  0  1  1  1  1  1 1 1 1 1  1  1  1 1 1  1  1 1  1  1  1  1  1 1 1 1  1  1  1  1  1  1  1  1  1  1  1 1 1 1 1 1 1  1  1 1  1  1